#######E########E####################
# ### #   ###### #    #     #     # #
# ### ### #      #  #    #     #    #
# ### # # # ###### ##################
#            #       #    #   #   # #
#  # ##      # ##### #  # # # # # # #
#  #         #   #   #  # # # # #   #
#  ######   ###  #  ### # # # # ### #
#  #    #               #   #   #   #
#  # ## ########   ## ###########   #
#    ##          ###                #
# ## ########## ##  ###   ####   ## #
#  ### ##         #  #  #           #
#  #   ## ####     #    #      ###  #
#  # #### #  #     #    #####       #
#  #      #      ###           ##   #
#  #####           #   ##   #   #   #
#                                   #
###############^#####################
